L---------------------------------
L---------------------------------
L-----------------S---------------
L-S-------------------------------
L--S---------1------1-------------
L----------------------------1----
L---------------------------------
L------1-------------------S------
L---------------------------------
L-------P------------------------R
----------------1------1------1--R
---------------------------------R
---------------------------------R
---------------------------------R
-------1---S---------------------R
---------------------1-----------R
---------------------------------R
----1--------1---------------1----
----------------------------------
-------------------S--------------
----------------------------------