----------111-----------------111--
----------111---1-------------111--
---111-----1-------------1-1---1---
---111---1-1S------1----111--------
----1-------------------111--------
-1111---------1----------1---------
-111--------------------------1----
-111-------------------------------
-11111---------------------1-------
-11111-----111---------------------
-11111-----111---------------------
L-----------1---------1------------
LP----------1----------------------
L--------1----1------------------1-
--111---------S-----------------111
--111------1--------------------111
---1----1-111-----1----S1--------1-
------1-1-111----------111---------
-----------1-----------111---------
------------------1-----1------1---
-----------------------------------