----------111-----------------111--
----------111---1-------------111--
---111-----1-------------1-1---1---
---111---1-1S------1----111--------
----1-------------------111--------
-1111---------1----------1---------
-111--------------------------1----
-111-------------------------------
-11111-------------P-------1-------
-11111-----111---------------------
-11111-----111--------------------R
------------1---------1-----------R
L-----------1---------------------R
L--------1----1------------------1-
--111---------S-----------------111
--111------1--------------------111
---1----1-111-----1----S1--------1-
------1-1-111----------111---------
-----------1-----------111---------
------------------1-----1------1---
-----------------------------------