11111111111111111111111111111111111
11111111111111111111111111111111111
11111111111111111111111111111111111
-1-----111111111111111111111111111-
-1-1111-----------------------111--
---1111-----------------------111--
---1111------------------------11--
-------------------------------11--
-----------------------------------
-----------------------------------
-----------------------------------
-----------------------------------
-----------------------------------
-----------------------------------
-----------------------------------
-----------------------------------
-----------------------------------
-----------------------------------
-----------------------------------
11111111111111111P11111111111111111
11111111111111111111111111111111111