-----1-----11111111111111----1-----
-----1-----11111111111111----1-----
-----1-----11111111111111----1-----
-----1-----------------------1-----
-----1-----------------------1-----
-----1----11-----------11----1-----
-----1----11-----------11----1-----
----1111--11-----11----11--1111----
----1111--11-----11----11--1111----
----1111-------------------1111----
----1111-------------------1111----
----1111111111111--111111111111----
----1111111111111--111111111111----
----1111111111111--111111111111----
-----------------------------------
-----------------------------------
-----------------------------------
-----------------------------------
-----------------------------------
-----------------------------------
-------------PPPP-PPPP-------------
