-------------------------1111111111
----------1---------1----1111111111
-------------------------1111111111
-------------------------1111111111
-1---------11------------1111111111
-------------------------11111UU111
-------1--------------1------------
-----------------------------------
L--1-------------------------------
L----------------1-----------------
L----------------1-----------------
L-------------------------1--------
L----------------------------------
L----------------------------------
L----------------------------------
-11--------------------------------
----------------------------------1
-----------------------------------
-1---------------------------------
-1--------------------------11-----
-----------1-----------------------
