-------------------------1111111111
----------1---------1----1111111111
-------------------------1111111111
-------G-----------------1111111111
-1---------11------------1111111111
-------------------------11111UU111
-------1--------------1------------
-----------------------------------
L--1-------G-----------------------
L----------------1-----------------
L----------------1-----------------
L---------W---------------1--------
L----------------------------------
L----------------------------------
L--------------G-------------------
-11--------------------------------
-------------------W--------G-----1
-----------------------------------
-1---------------------------------
-1--------------------------11-----
-----------1-----------------------
