--1111111----111-------------------
--1111111-----1--------------------
--111111------1-----------11111111-
-111111111-------------------------
-1111111111111111111111111111111111
-11111111111111111111111111--1--111
-1111111111111111111111----------11
----------111111111--------------11
-----------1---------------111-----
-1-111----111----1---------111----R
111111----111---------------1-----R
111-1--1---1----------------------R
L1----111-------------------------R
L-----111--------------------------
-------1---1-----------------------
-----------------------------------
-----------------------------------
------------------111--------------
------------------111--------------
----------------1--1------------1--
-----------------------------------