--1111111----111-------------------
--1111111-----1--------------------
--111111------1-----------11111111-
-111111111-------------------------
-1111111111111111111111111111111111
-11111111111111111111111111--1--111
-1111111111111111111111----------11
----------111111111--------------11
-----------1---------------111-----
---111----111----1---------111----R
---111----111---------------1-----R
L---1--1---1----------------------R
L-----111--------W-----------G-----
L-----111--------------------------
L------1---1-----------------------
-----------------------------------
-----------------------------------
-----B------------111--------------
------------------111---W----------
----------------1--1------------1--
-----------------------------------