---111111-1111111111111111111111111
---111111-1111111111111111111111111
-------1-1-1111111--1--1-1-1111111-
L-------111111111--1111111111111111
L-------1111111111-1111111111111111
---------11111111111111111111111111
----------1111111111--111-111111111
-1---------1-1---1111-111-111111111
111---------------111--1---1-1---1R
111----------------1--------------R
-1-1------------------------------R
--111-----------------------------R
--111-----------------------------R
11-1----1------1---------1--------R
11111--111--1-111---1---111-1-----R
11111--111-111111--1111-11111111---
111111-----111-1--111111-1-111111--
1111111-----1----111-111--111-111--
11111111111111---111--1---111--1---
11111111111111111-1--------1-------
11111111111111111------------------
