----------111-----------------111--
----------111-----------------111--
---111-----1-------------1-1---1---
---111---1-1-------1----111--------
----1-------------------111--------
-1111---------1----------1---------
-111--------------------------1----
-111-------------------------------
-11111----------------------------R
-11111-----111-------S------------R
-1P111-----111--------------------R
------------1---------1-----------R
------------1-------G-------------R
---------1----1------------------1R
--111----------------B----------111
--111------1--S-----------------111
---1------111-----------1--------1-
------1---111----------111---------
-----------1-----------111---------
------------------1-----1------1---
-----------------------------------