----------111-----------------111--
----------111-----------------111--
---111-----1---1---------1-1---111-
---111---1-1---1---1----111----111-
----1-------------------111----111-
-1111---------1----------1------1--
-111-----------------1--------1----
-111----------------111-S--1-------
-11111---G-----B----111----1-------
-11111-----111-------1-------------
-1P111-----111---------------------
------------1-----S---1---B--S-----
------------1---------------------R
---------1----1------------S------R
--111-----------------------------R
--111-S----1---B-------------S-----
---1----1-111-----1-----1---1----1-
------1-1-111-----1----111-111--111
-----------1-----------111-111--111
------------------1-----1---1--1---
-----------------------------------