----------111-----------------111--
----------111-----------------111--
---111-----1---1---------1-1---111-
---111---1-1---1---1----111----111-
----1-------------------111----111-
-1111---------1----------1------1--
-111--------------------------1----
-111------------S----------1-------
-11111---------------------1-------
-11111-----111-------S-------------
-1P111-----111---------------------
------------1---------1------S-----
------------1-------S-------------R
---------1----1-------------------R
--111-----------------------------R
--111------1--S--------------------
---1----1-111-----1-----1---1----1-
------1-1-111-----1----111-111--111
-----------1-----------111-111--111
---------------S--1-----1---1--1---
-----------------------------------