11111111111111111111111111111111111
11111111111111111111111111111111111
11111111111111111111111111111111111
1111111111111UUUU1UUUU1111111111111
1111111111111----1----1111111111111
------------11-------11------------
-----------111-------111-----------
1111111111111-1-----1-1111111111111
111111111111111-----1-1111111111111
111111111111111-----111111111111111
111111111111111-----111111111111111
11111111111111-------11111111111111
11111111111111-------11111111111111
1111111111111---------1111111111111
11111111111111-------11111111111111
11111111111111-------11111111111111
1111111111111---------1111111111111
11111111111111-------11111111111111
11111111111111-------11111111111111
1111111111111---------1111111111111
11111111111111DDDDDDDD1111111111111