11111111111111111111111111111111111
11111111111111111111111111111111111
11111111111111111111111111111111111
00000000000000000000000000000000000
00000000000000000000000000000000000
00000000000000000000000000000000111
00000000000000000000000000000000111
00000000000000000000000000000000111
00000000000000000000000000000001111
00000000000000000000000000000001111
00000000000000000111111110011111111
00000000111111000111111111111111111
00000011111111000111111111111111111
11111111111111000111111111111111111
11111111111111000111111111111111111
11111111111111000111111111111111111
11111111111000000000000111110011111
11111111000000000000000011100000000
00001111000000000000000000000000000
00000000000000000000000000000000000
00000000000000000000000000000000000