00000100000111111111111110000100000
00000100000111111111111110000100000
00000100000111111111111110000100000
00000100000000000000000000000100000
00000100000000000000000000000100000
00000100001100000000000110000100000
00000100001100000110000110000100000
00001111001100000110000110011110000
00001111001100000110000110011110000
00001111000000000000000000011110000
00001111000000000000000000011110000
00001111111111111111111111111110000
00001111111111111001111111111110000
00001111111111111001111111111110000
00000000000000000000000000000000000
00000000000000000000000000000000000
00000000000000000000000000000000000
00000000000000000000000000000000000
00000000000000000000000000000000000
00000000000000000000000000000000000
00000000000000000000000000000000000
