00000000000000000000000001111111111
oooooooooo1ooooooooo1oooo1111111111
00000000000000000000000001111111111
00000000000000000000000001111111111
01000000000110000000000001111111111
00000000000000000000000001111111111
00000001000000000000001000000000000
00000000000000000000000000000000000
00010000000000000000000000000000000
00000000000000000100000000000000000
00000000000000000100000000000000000
00000000000000000000000000100000000
00000000000000000000000000000000000
00000000000000000000000000000000000
00000000000000000000000000000000000
01100000000000000000000000000000000
00000000000000000000000000000000001
00000000000000000000000000000000000
01000000000000000000000000000000000
01000000000000000000000000001100000
00000000000100000000000000000000000
