00011111101111111111111111111111111
00011111101111111111111111111111111
00000001010111111100100101011111110
00000000111111111001111111111111111
00000000111111111101111111111111111
00000000011111111111111111111111111
00000000001111111111001110111111111
01000000000101000111101110111101111
11100000000000000011100100010100010
11100000000000000001000000000000000
01010000000000000000000000000000000
00111000000000000000000000000000000
00111000000000000000000000000000000
11010000100000010000000001000000000
11111001110010111000100011101000000
11111001110111111001111011111111000
11111100000111010011111101011111100
11111110000010000111011100111011100
11111111111111000111001000111001000
11111111111111111010000000010000000
11111111111111111000000000000000000
