------------------------111--------
-----1-----111----111----1---------
----111----111----111--------------
-----1-----------------------------
-----------------------------------
-----------------------------------
------------------1----------------
-----------------111---------------
------------------1----------------
------------------1111----111------
---------------1---111---1111111-11
--------------111111111111111111111
---------1-----1111111111111111111-
--------111----11111111111111111111
---------1---1-11111111111111111111
11111----1--11111111111111111111111
111111-------1111111111111111111111
11111111----11111111111111111111111
111111111--111111111111111111111111
11111111111111111111111111111111111
11111111111111111111111111111111111
