-------111--1-----1------------111-
-1------1--------111------------1--
---11-------------1-------------1--
1111111111111111--1----1-----------
1111111111111111-11-----------1---1
11111111111111111------------------
111111111111111111-----1-----------
111111111111111111111-1111--------R
----11111111111111111-11111-------R
L------11111111111111-11--1--------
L----1---111111111------111--------
L---------11111111------111--1-----
------------------------11--111----
---------------1111--11-111--1----1
----------------1111-111--1-------1
---------------1-1111-111111--11111
-------111-------111111111111111111
-1-----111------1-11111111111111111
----1---1----1-111--111111111111111
--------1-1-----1--1-11111111111111
--------------------111111111111111