0000000001110000000000000000011100
0000000001110000000000000000011100
0011100000100000000000001010001000
0011100010100000001000011100000000
0001000000000000000000011100000000
1111000000000100000000001000000000
1110000000000000000000000000010000
1110000000000000000000000000000000
1111100000000000000000000000000000
1111100000111000000000000000000000
1111100000111000000000000000000000
0000000000010000000001000000000000
0000000000010000000000000000000000
0000000010000100000000000000000010
0111000000000000000000000000000111
0111000000100000000000000000000111
0010000001110000000000010000000010
0000010001110000000000111000000000
0000000000100000000000111000000000
0000000000000000010000010000001000
0000000000000000000000000000000000