00111111100001110000000000000000000
00111111100000100000000000000000000
00111111000000100000000000111111110
01111111110000000000000000000000000
01111111111111111111111111111111111
01111111111111111111111111100100111
01111111111111111111111000000000011
00000000001111111110000000000000011
00000000000100000000000000011100000
01011100001110000100000000011100000
11111100001110000000000000001000000
11101001000100000000000000000000000
01000011100000000000000000000000000
00000011100000000000000000000000000
00000001000100000000000000000000000
00000000000000000000000000000000000
00000000000000000000000000000000000
00000000000000000011100000000000000
00000000000000000011100000000000000
00000000000000001001000000000000100
00000000000000000000000000000000000