11111111111111111111111111111111111
11111111111111111111111111111111111
11111111111111111111111111111111111
01000001111111111111111111111111110
01011110000000000000000000000011100
00011110000000000000000000000011100
00011110000000000000000000000001100
00000000000000000000000000000001100
00000000000000000000000000000000000
00000000000000000000000000000000000
00000000000000000000000000000000000
00000000000000000000000000000000000
00000000000000000000000000000000000
00000000000000000000000000000000000
00000000000000000000000000000000000
00000000000000000000000000000000000
00000000000000000000000000000000000
00000000000000000000000000000000000
00000000000000000000000000000000000
11111111111111111111111111111111111
11111111111111111111111111111111111