11111111111111111111111111111111111
11111111111111111111111111111111111
11111111111111111111111111111111111
11111111111111111111111111111111111
11111111111110000100001111111111111
00000000000010000000001000000000000
00000000000111000000011100000000000
11111111111110100000101111111111111
11111111111111100000101111111111111
11111111111111110000011111111111111
11111111111111110000010111111111111
11111111111111100000001111111111111
11111111111111100000001111111111111
11111111111111100000001111111111111
11111111111111100000001111111111111
11111111111111100000001111111111111
11111111111111100000001111111111111
11111111111111100000001111111111111
11111111111111100000001111111111111
11111111111111100000001111111111111
11111111111111100000001111111111111