00000001110010000010000000000001110
01000000100000000111000000000000100
00011000000000000010000000000000100
11111111111111110010000100000000000
11111111111111110110000000000010001
11111111111111111000000000000000000
11111111111111111100000100000000000
11111111111111111111101111000000000
00011111111111111111101111100000000
00000001111111111111101100100000000
00000100011111111100000011100000000
00000000001110000000000011100100000
00000000000000000000000011001110000
00000000000000011110011011100100001
00000000000000001111011100100000001
00000000000000010111101111110011111
00000000100000000111111111111111111
01000001110000001011111111111111111
00001000100001011100111111111111111
00000000101000001001011111111111111
00000000000000000000111111111111111