00000000000000000000000011100000000
00000100000111000011100001000000000
00001110000111000011100000000000000
00000100000000000000000000000000000
00000000000000000000000000000000000
00000000000000000000000000000000000
00000000000000000010000000000000000
00000000000000000111000000000000000
00000000000000000010000000000000000
00000000000000000011110000111000000
00000000000000010001110001111111011
00000000000000111111111111111111111
00000000010000011111111111111111110
00000000111000011111111111111111111
00000000010001011111111111111111111
11111000010011111111111111111111111
11111100000001111111111111111111111
11111111000011111111111111111111111
11111111100111111111111111111111111
11111111111111111111111111111111111
11111111111111111111111111111111111
